S#####..
.......#
#.#.#.#.
#.#.#..G
...#....
##...###
